ʃ ʒ þ ð ç ŋ æ
zdrom	small
parom	fast
sjogom	big
dʒin	low
spiiç	long
ʒiʒom	sharp
mjaa	good
dziik	deep
zjontatsom	different
dajom	wise
dantsom	bare
-iz	dark
-ŋov	light
-eldin	green
-sukh	red
-zælin	yellow
-dulom	blue
-guretsk	brown
ŋants	as well
kjellom	wide
maltjom	serene/calm and content
mavjom	hallowed
ʃlauv	young
kavom	pet
kvietu	brave
dzulom	early
kævjur	important
ʒeʒe	okay
gutsom	bad
tægeŋ	happy
braʒom	strong
