ʃ ʒ þ ð ç ŋ æ
ekk	must (imperative marker)	
gjev	may (subjunctive marker)	
suç	that (relative clause marker)	
pjo	what (interrogative marker)
ve	the
tsi/eln	if/then (conditional)
tun	one
hen	two
krem	three
dʒoko	four
por	five
yet	six
vu	seven
rat	eight
silfrʒ	nine
tjun	ten
khaiʃ	hundred
khaitʃu	thousand
fulmer	ten thousand
fjulmer	hundred thousand
defjelmer	million
